XXXXXXXX
XG.X...X
X......X
XG.XXXXX
X..XM..X
X..X...X
XGJX...X
XX.XX..X
X.J..J.X
X.....XX
XXXXXXXX