XXXXXXXX
XM..XXXX
XGGGXXXX
XJ.XXXXX
X.JX...X
X..J...X
X......X
XXXXXXXX