XXXXXXXX
XM.XXXXX
X.JXXXXX
X......X
X.X.JX.X
XGJG..GX
XXXXXXXX