XXXXXXXX
XXXX...X
XXG..X.X
XX.J...X
XGGXJJXX
XG..JMXX
X..XXXXX
XXXXXXXX